b001100222
0111110002
000220112b
0002000000
1010b00100
0012222100
0010000100
0000000000