0002222000
0111111110
0222222220
0011111100
0000000000
0121212120
1000000000
0000000001