0000000000
0111110000
0002000000
0002000000
0010000100
0012222100
0010000100
0000000000